Hitpoints
{2,3,4,4,5,5,6,6,7,7,8,10,12,15},
{5,6,7,8,9,10,11,12,14,16,18,21,25,30},
{3,4,5,5,6,7,8,9,10,11,12,15,19,25},
{6,8,9,10,12,14,16,18,20,22,25,30,40,50},
{2,3,4,5,6,7,8,8,9,9,10,12,15,20}

Attacks
{-5,-4,-3,-2,1,1,1,2,2,2,2,2,2,3},
{1,1,2,2,2,3,3,3,4,4,5,5,6,6},
{-2,-2,-2,1,1,1,2,2,2,3,3,3,4,4},
{-2,-2,1,1,1,2,2,2,2,2,3,3,3,4},
{-5,-4,-3,-2,-2,1,1,1,1,1,2,2,2,2}

Bowshots
{-3,-2,1,1,1,2,2,2,2,3,3,3,4,4},
{-4,-3,-2,1,1,2,2,2,2,3,3,3,3,4},
{1,1,2,2,2,3,3,3,4,4,5,5,6,7},
{0,-4,-3,-2,1,1,2,2,2,2,2,3,3,3},
{0,0,-4,-3,-3,-2,-2,1,1,1,2,2,2,3}

Lock Pick
{1,1,2,2,3,3,4,4,5,5,6,6,6,7},
{0,0,0,0,0,1,1,1,1,1,2,2,3,3},
{0,0,0,0,0,0,0,0,0,0,0,0,0,1},
{0,0,0,1,1,1,2,2,3,3,4,4,5,5},
{0,0,0,0,0,0,0,0,0,0,0,0,1,1}

Strength bonus
{0,0,0,0,0,0,0,0,0,0,1,1,1,2},
{0,0,0,0,0,1,1,1,1,1,2,2,2,3},
{0,0,0,0,0,0,0,0,1,1,1,1,2,2},
{0,0,1,1,1,2,2,2,2,3,3,3,3,4},
{0,0,0,0,0,0,0,0,0,0,1,1,1,1}

Magic
{1,1,1,1,2,2,2,2,3,3,3,3,3,4},
{0,0,0,0,0,0,0,0,1,1,1,1,2,2},
{1,2,2,2,2,2,3,3,3,4,4,4,4,5},
{0,0,0,0,0,0,0,0,0,0,1,1,1,2},
{2,2,3,3,3,4,4,4,5,5,5,5,5,6}

Fireballs
{1,1,1,1,1,1,1,2,2,2,2,2,2,3},
{0,0,0,1,1,1,1,1,2,2,2,2,2,3},
{0,0,0,1,1,1,1,2,2,2,2,2,2,3},
{0,0,0,0,0,1,1,1,1,1,1,1,2,2},
{0,0,1,1,2,2,3,3,4,4,5,5,6,6}

Bolts
{1,1,1,2,2,2,2,2,2,2,3,3,3,4},
{0,0,1,1,1,1,2,2,2,2,2,3,3,3},
{0,1,1,1,1,2,2,2,2,3,3,3,3,4},
{0,0,1,1,1,1,1,1,1,1,2,2,2,2},
{1,1,1,2,2,3,3,4,4,5,5,6,6,6}

Max staffs
{1,1,2,2,3,3,4,4,5,5,6,7,8,9},
{0,0,1,1,2,3,3,4,5,5,6,7,8,9},
{0,1,2,2,3,3,4,4,5,5,6,7,8,9},
{0,0,1,1,2,2,2,3,3,4,4,5,6,7},
{1,1,2,3,4,5,5,6,6,7,8,9,10,10}
